NO ./texture/grass.xpm
SO ./texture/greystone.xpm
WE ./texture/planks.xpm
EA ./texture/redbrick.xpm

F 220,100,0
C -2555555555,30,0


11111111111111111111111111111111111111111111111111111 
100000000000000000000000000000000000000000000000000001
100000000000000000000000000000000000000000000000000001
100000000000000000000000000000000000000000000000000001
100000000000000000000000000000000000000000000000000001
100000000000000000000000000000000000000000000000000001
100000000000000000000000000000000000000000000000000001
100000000000000000000000000000000000000000000000000001

100000000000000000000000000000000000000000000000000001
100000000000000000000000000000000000000000000000000001
100000000000000000000000000000010000000000000000000001
100000000000000000000000000000000000000000000000000001
100000000000000000000000000000000000000000000000000001
100000000000000000000000000000000000000000000000000001
100000000000000000000000000000000000000000000000000001
100000000000000000000000000000000000000000000000000001
1000000000000000000000000000000000000000000000000000S1
11111111111111111111111111111111111111111111111111111 

