NO ./texture/text.xpm
SO ./texture/text.xpm
WE ./texture/text.xpm
EA ./texture/text.xpm

F 220,100,0
C 225,30,0

 11111 
1000001
 11111 