





SO ./texture/grass.xpm



WE 	 								    	./texture/grass.xpm


EA 													./texture/bricks.xpm

NO ./texture/grass.xpm

C    0,2147483647,0
F 0,0,0



















111111111111111111111111111111111111111111111111111111
111111111111111111111111111111111111111111111111111111
100000000000000000000000000000000000000000000000000001
100000000000000000000000000000000000000000000000000001
100000000000000000000000000000000000000000000000000001
100000000000000000000000000000000000000000000000000001    
100000000000000000000000000000000000000000000000000001
100000000000000000000000000000000000000000000000000001
100000000000000000000000000000000000000000000000000001
100000000000000000000000000000000000000000000000000001
100000000000000000000000000000000000000000000000000001
100000000000000000000000000000000000000000000000000001
100000000000000000000000000000000000000000000000000001
100000000000000000000000000000000000000000000000000001
100000000000000000000000000000000000000000000000000001
100000000000000000000000000000000000000000000000000001
100000000000000000000000000000000000000000000000000001
111111111111111111111111111111111111111111111111111111
                                                    1
111111111111111111111111111111111111111111111111111111
100000000000000000000000000000000000000000000000000001
100000000000000000000000000000000000000000000000000001
100000000000000000000000000000000000000000000000000001
100000000000000000000000000000000000000000000000000001
111111111111111110000000000011111111111111111111111101
100000000000000000001111111111100000000000000000000001
1000000000000000000001100S0010000000000000000000000001
100000000000000000000011000100000000000000000000000001
100000000000000000000000101000000000000000000000000001
100000000000000000000000010000000000000000000000000001
100000000000000000000000000000000000000000000000000001
111111111111111111111111111111111111111111111111111111
111111111111111111111111111111111111111111111111111111



