NO ./texture/grass.xpm
SO ./texture/greystone.xpm
WE ./texture/planks.xpm
EA ./texture/redbrick.xpm

F 220,111,119
C 225,111,0

11111111111111111111
11111111111111111111
11111111111111111111
11111100011111111111
1111110S011111111111
11111100011111111111
11111111111111111111
